0,0,0,0,0
0,4,2,3,0
0,1,4,0,0
0,0,0,0,0
0,0,0,0,0