0,0,0,0,0
0,1,5,5,0
0,7,1,1,0
0,2,4,3,0
0,0,0,0,0