0,0,0,0,0
0,3,2,7,0
0,7,4,3,0
0,0,0,0,0
0,0,0,0,0