0,0,0,0,0,0,0,0
0,3,2,6,5,0,0,0
0,1,0,7,4,0,0,0
0,0,0,0,0,0,0,0
0,0,0,0,0,0,0,0