0,0,0,0,0
0,3,1,0,0
0,2,6,0,0
0,0,0,0,0
0,0,0,0,0