0,0,0,0,0,0,0,0
0,3,2,6,5,5,1,0
0,1,0,7,4,5,0,0
0,7,2,2,6,6,0,0
0,0,0,0,0,0,0,0