0,0,0,0,0,0,0,0
0,0,5,3,0,0,0,0
0,0,1,7,0,0,0,0
0,0,0,0,0,0,0,0
0,0,0,0,0,0,0,0