0,0,0,0,0,0,0,0
0,0,1,3,0,0,0,0
0,0,1,6,0,0,0,0
0,0,0,0,0,0,0,0
0,0,0,0,0,0,0,0