0,0,0,0,0
0,7,3,1,0
0,5,1,5,0
0,0,0,0,0
0,0,0,0,0
