0,0,0,3,0,0,0,0
0,0,7,2,3,0,0,0
0,0,4,6,4,0,0,0
0,0,3,0,0,0,0,0
0,0,0,0,0,0,0,0