0,0,0,0,0
0,2,1,3,0
0,3,4,4,0
0,2,2,7,0
0,0,0,0,0