0,0,0,0,0,0,0,0
0,0,2,5,4,0,0,0
0,0,3,3,7,0,0,0
0,0,2,6,2,0,0,0
0,0,0,0,0,0,0,0