0,0,0,0,0
0,6,2,1,0
0,7,1,3,0
0,0,0,0,0
0,0,0,0,0
