0,0,0,0,0
0,2,5,1,0
0,7,4,3,0
0,0,0,0,0
0,0,0,0,0
