0,0,0,0,0
0,6,7,2,0
0,2,3,7,0
0,0,0,0,0
0,0,0,0,0
