0,0,0,0,0
0,1,5,3,0
0,7,1,6,0
0,1,7,2,0
0,0,0,0,0